0320013220231301203202323012002
3102132200102213311101102223320
1330310333033230123310002212322
3332333133232213223312030100220
1120330310221121000033001012330
1133332302222002223332001101220
0132010313301020111213111312102
3303112211113000030002001312030
0130010032231112022002201022302
1002030320211131133322120130100
1013333131302322122210210310130
3223202100100001221111113301312
1220200033200203202112330103202
0303113222223010321020121120222
1100212131332003013210322223202
0200003301220022233002332210032
0021003231021110012333323110112
3211031300223233222031223103122
0333000330022113030021223202322
0010003033231121010123123212210
1100000101101110001101110111010