032001322023130120320
232301200123102132200
102213311101102223320
133031033303323012330
002212322333233313322
213223312030100223012
033031022112100003300
101233011333323022220
022233320011012200132
010313301020111213112
101011111100000000010